13,9
WWPPPPPPPPPWW
WWPPPPPPPPPWW
WWPP_____PPWW
WWPP_____PPWW
WWPP__E__PPWW
WWPP_____PPWW
WWPP_____PPWW
WWPPPPPPPPPWW
WWPPPPPPPPPWW