13,9
E_____W_____E
W__WW____WWW_
___W__W______
W_______W_W_W
WW_W_W_______
_______W_WW_W
___WW___W____
W_____W____W_
E__W____WE___