13,9
E_____P_____E
P__PP____PPP_
___P__P______
P_______P_P_P
PP_P_P_______
_______P_PP_P
___PP___P____
P_____P____P_
E__P____PE___