13,9
PPPPPPPPPPPPP
P__PP___PP_EP
PP____P____PP
PP_P_PP_P_PPP
PP____E____PP
PPP_P_PP_P_PP
PP____P____PP
PE_PP___PP__P
PPPPPPPPPPPPP