13,9
PP-P-PPP-P-PP
P-PPP-P-PPP-P
-P-P-PPP-PPP-
P-PPP-P-P-P-P
PPPP-PPP-P-PP
P-P-P-P-P-PPP
-PPP-P-PPP-P-
P-PPP-P-P-P-P
PP-P-PPP-P-PP