13,9
PPP______ePPP
PPfP_PPPPP_PP
PP_P_______PP
PP_P_P_P_P_PP
PP_P_____P_PP
PP_P_P_P_P_PP
PP_______P_PP
PP_PPPPP_PfPP
PPPe______PPP