13,9
PPP______EPPP
PPFP_PPPPP_PP
PP_P_______PP
PP_P_P_P_P_PP
PP_P_____P_PP
PP_P_P_P_P_PP
PP_______P_PP
PP_PPPPP_PFPP
PPPE______PPP