13,9
PPE________PP
PP_PPPPP_P_PP
PP___P___P_PP
PP_P_P_PPP_PP
PP_P_____P_PP
PP_PPP_P_P_PP
PP_P___P___PP
PP_P_PPPPP_PP
PP________EPP