13,9
PPp___p___pPP
PP_PPPPPpP_PP
PP_p_Ppp_P_PP
PP_PpP_PPP_PP
PPpPp_p_pPpPP
PP_PPP_PpP_PP
PP_P_ppP_p_PP
PP_PpPPPPP_PP
PPp___p___pPP