13,9
PPP___P___PPP
PP_PPPPPPP_PP
PP_P_PPP_P_PP
PP_PPP_PPP_PP
PPPPP_P_PPPPP
PP_PPP_PPP_PP
PP_P_PPP_P_PP
PP_PPPPPPP_PP
PPP___P___PPP